444443333344444321000011432100000000000000000021000044444444444444444444444444432111112111221000
4444432222444443222100004443210000000000000000210022444444444444444444444444444321000011MM111000
444443211144444321110000444443210000210044444321001144444444444444444444433333332100001MM1MM1121
33334321004444432100000044444321002221003333432100003344444444444444444443222222433333333221MM21
22224321004444432100001144444444432111002222332100002233444444444444444443211111432222223211MM21
2111444444444443222100004444444443210000111122432100112233444444444444444321000043211111321MM221
210033333333344321110000444444444321000000001143210000112244444444444444432100004321000043321111
443222222222244321000000444443333343210000000044432100001144444444444444432100004321000043221MM1
333211121111144321000011444443222244432100210044444321000044444444444444432222224321000043211111
22221MM11VVVV44443210000444443211144444443210033444321000044444444444444432111113321000443210000
211121MM1VVVV44443210000444443210044444443210022444321004444444444444444432100002221000333210000
11MM44444444444443210000334443210044444443210011444321003344444444444444432100001111144322210000
1MM144444444444443210000223344444444444443210000333321002233444444444444432100001000043321111321
21MM44444444444443210000112233444444444443210000222221001122444444444444444444321000043221000321
111244444444444444432100001122334444444444432100111121000011444444444444444444321000043211000321
1MM144444444444444444321000011224444444444432100000022210000444444444444444333333333333210000321
21MM44444444444444444443210000114444444444444321000011210000444444444333333322222222223210000221
444444444444444444444444432100004444444444444443210000110044444444433322222221111111112210000111
444444444444444444444444432100004444444444444444432100000044444444432221111111000000001122211100
444444444444444444444444432100004444444444444444444321000044444444432111000000000000000011110000
444444444444444444444444432100004444444444444444444444444444444444432100000000444443210000000021
444444444444444444444444432100003344444444444444444444444444444444432100224444444444432100004321
444444444444444444444444432100002244444444444444444444444444444444432100114444444444444444444321
444444444443333333334444432100001143333333444444444444444444444444432100003344444444444444444321
444444433333222222223344432221000033222222444444444444444444444444432100002244444444444444444321
444443332222211111112233332111000022211111444444444444444444444444432100001144444444444444444321
333333222111110000001122222100000021110000444444444444444444444444433321000044444444444444444321
222222211100000000000011111100000021000000444444444444444444444443332221110044444333333333334321
111111110000000000000000000000000021000044444444444444444444444443222111000044444322222222224321
000000000000000043210000000000004443333333333344444444444444444333211100000044444321111111114321
000000000000004444432100000000004333222222222233333344444444444322210000000044444321MM1MM1MM4321
00000000444444444444444333333333332221111111112222223344444444432111000000004444433321MM1MM44321
443333333333334444444443222222222221110000000011111122334444444321000000000044433322222233333321
433222232222224444444443211111111121000000000000000011224444444321000011224443332221111122222221
332211122111114444444443210000000021000000432100000000113333444443210000114333222111000011211111
32211MM111VVVV4444444443210000000011000000444444432100002222334444432100003322211100000000210000
3211MM1MM1VVVV4444444444432100001100004444444444432100001111223344444321002221110000432100210000
321MM4444444444444444444444443210000224444444444432100000000112233444321001111000044432100112221
221114444444444444444444444443210000114444444444444321000000001122444321000000004444432100001111
211MM4444444444444444444444443210000004444444444444444321111000011444443210000114444444321000000
21MM44444444444444444444444444432100003333444444444444321VVVV10000334444444321004444444443210000
444444444444444444444444444444432100002222334444444444321VVVV10000224444444444444444444444444321
444444444444444444444444444443332100001111223334444444444443210000114444444444444444444444444321
444444444444444444444444444333222100000000112223444444444444432100004444444444444444444444444321
444444444444444444444444444322211100000000001112333333444444432100004444444444444444444444444321
444444444444444444444444444321110000000000001MM1222222344444432100003344444444444444444444333321
4444444444444444444444444443210000004321000011MM111111244444432100002233444444444444444443322221
4444444444444444444444444443210000444321000000111MM1MM144444432100001122444444444444444443221111
44444444444444444444444444444444444444432100000021MM1MM44444433321000011444444444444444443211MM1
44444444444444444444444444444444444444444321000011222233333333222221000044444444333333333321MM21
333344444444444444444444433333334444444443210000001111222222222111110000444444443222222222211121
22223333333333444444444333222222333344444321000000000011111121110000000033444444321111111111MM21
11112222222222334444433322211111222233444443210000000000000011000000001122444444321VVVV1MM1MM321
00001111111111223333332221110000111122444443210000000000000000000000000011444444321VVVV321MM4321
000000000000001122222221110000000000113344432221111121000000000000000000004444444444444444444321
432100000000000011111111000021000000002244432111000011223321000044432100003333333333334444444321
333333332100210000000000004321000000001144432100000000112222223344444333222222222222223344444321
222222233444432100000000444321000000000044432100000000001111112244433322211111111111112233333321
211111122444444444444444444321111111000044432100000000000000001143332221110000000000001122222221
11MM1MM11444444444444444433321000000004444432100002221000000000033222111000000000000000011111121
1MM1MM1MM444444444444443332221000000444444444443222111110000000022211100004321114321000000000011
444444444444444444444333222111003333444444444443211100001144444321110000444321004444432100000000
444444444444444444444322211100002222444444444443210000000044444321000044444444444444444444432100
444444444444444444444321110000432111444444444443210000000044444321000044444444444444444444444321
444444444443333333444321000033432100444444444444432100004444433321000044444444444444444444444321
444444444333222222444321002222432100444444444444444444444444432221000044444444444444444444444321
444444444322211111444321002111334444444444444444444444444444432111000044444444444444444444444321
433333334321110000334321002100223344444444444444444444444444432100004444444444444444444333334321
332222223321000000224321001111112233444444444444444444444444432100003344444444444444444322224321
222111112221001100114321000000001122334444444444444444444444432100002233444444444444444321113321
211100001121000000004443210000000011224444444444444444444444432100001122444444444444444321MM2321
110000000021000000004444444443210000114444444444444444444444432100000011444444444444444432111321
0000432100111100210044444444432111000044444444444444444444444443210000004444444444444443321MM321
004443210000000011004444444443210000004444444444444444444444444321110000444444433333333322111321
4444432100000000000044444444444321004444444444444444433333444443210000113344444322222222211MM321
444444444443210000004443333333332100444444444444444443222244444321000000223344432111111111MM2221
4444444444444321000033332222222221004444444444444444432111444443210000001122444321VVVVMM1MM32111
4444444444444443210022222111112111004444444333333344432100444444432100000011444321VVVV21MM432100
444444444444444321001111110000110000444443332222223344444444444443210000000033444444444444444321
444444444444444321000000000000000044444443222111112233444444444443222111000022444444444444444321
444444444444444443210000000000004444444443211100001122334444444443211100002111444444444444444321
444444444444444444444444444444444444444443210000000011223344444443210000222100333344444444444321
444444444444444444444444444444444444444443210000210000112244444443210000112233222244444444444321
444444444444444444444444444444444444444443222100332100001144444443210000001122211144444444444321
444444444444444444444444444444444444433333211100222221000033444443222100000011210044444444444321
333344444444444444444444444444444444432222210000211111210022444443211121000000113333334444444321
222244444444444444444444444444444444432111110043210000210011444443210043210000002222224444444321
211134444444444444444444444444444444432100000033210000210000444443210043211100002111114444444321
11MM24444444444444444444444444444444432100000022334443210000433333334443210000222100003333334321
1MM114444444444444444444444444444444444321001111224443210022332222224443210000112233432222224321
211MM3333333334444444444444444444444444321000000114443210011222111114443210000001122432111114321
21MM22222222224444444444444444444444444321000000004443210000112100003344432100000011432100003321
222111111111113333333333333333333333333333333321003333332100002100002233333321000000332111222221
1111MM1MM1VVVV2222222222222222222222222222222221002222222221002100001122222222210000222100111111
000001MM11VVVV1111111111111111111111111111111111001111111111001100000011111111110000111111100000
000000000000000000000000000000000000000000000000000000000000000000000000000000000000000000000000
