00000000001111000011110000111100000000000022210000221112111444444321000000002100004444444443211111000021000044444444444321111121
21000000000000000000000000000000000000000021110000111MM11MM444444321000000432100003344444333210000000044444444444444444321VVVV21
110000000000000000000000000000000000000021110000001MM21MM44444444321000044432100002244433322210000000044444444444444444321VVVV21
00000000002221000000000000000000000000332100000021MM4444444444444444444444432100001144432221110000004444444444444444444322224321
00000000111111222221000000002221000022222100004321114444444444433333334444432100000033432111000000004444444444444444444321113321
00000000000000111111210000432111000011211100004321MM4444444443332222223344432111000022432100000000004444444444444443333321MM2221
21000000000000000000114333332100000000210000004444444444444443222111112233432100001111432100000000004444444444333333222221MM1111
43210000000000000000003322222100000000210000444444444444444443211100001122432100000000334321000011224444444444322222211111110000
3332222222222100000000222111112100002111000044444444444444433321000000001143210000000022334321000011444444444332111111MMMM000000
32221111111122332100001111000011222111000000444443333333333322210000000000444321000000112244432100003344444443221MMMM11100004321
32111MM1MMMM11222100000000000000112100000044444333222222222221110000000000444321000000001144432100002244444443211100000000444321
321MM1MM4321MM111111000000000000002100004333333322211111111111000000000000444321000000000044432100001144444443210000000044444321
444444444444321VVVV3210000432100002100003322222221110000000000000000000000444321000000000044444321000044444443210000000033444321
444444444444321VVVV4444443332100001100002221111111000000000000000000000044433322211100004444433321000044444443210000000022334321
44444444444444444444444333222100000000002111000000000000000000000000000043332221110000444444432221000044444444432100000011224321
44444444444444444444444322211100000000001100000000000000000000000000000043222111000044444444432111000044444444432100000000114321
44444444444444444444444321110000000000000000000000000000000000000000004443211100004444444443332100000044444444432100000000004321
44444444444444444444444321000000000000000000000000000000000000004444444333210000444443333333222100000033333333432100000000004321
44444444444444444444444321000000000000000000000000000000000000444444433322210000444333222222211100000022222222333333210000444321
44444444444444444444444443210000000000000000000000000000000044433333332221110000433322211111110000002111111111222222210000444321
44444444444444444444444443210000000000000000000000000000004443332222222111000043332221110000000000001100000000111111110000444321
44444444444444444444444443210000000000000000000000004444444333222111111100004333222111000000000000000000000000000000000044444321
44444444444444444444444444432100000000000000000000444444444322211100000000433322211100000000000000000044444321000000004444444321
44444444444444444444444444432100000000000000000044444333333321110000000043332221110000000000000000000044444444444444444444444321
44444444444444444444444444432100000000000000004444433322222221000022222233222111000000000000000000000044444444444444444444444321
44444444444444444444444444444321000000000000444443332221111111000011111122211100000000000000000000004444433333333333444444444321
44444444444444444444444444444444444444444444444443222111000000000000000021110000000000000000004444433333332222222222444444444321
44444444444444444444444444444444444444444444444443211100000000000000000021000000000000001100004443332222222111111111444444444321
44444444444444444444444444444444444444444444444333210000000000000000000011000000000000000000004443222111111100000000333333333321
44444444444444444444444444444444433333333333433322210000000000002100000000000000000000000000444443211100000000000000222222222221
44444444444444444444444444444443332222222222332221110000000000332100000000000000000000004444444443210000000000000000111111111111
44444444444444444444444444444333222111111111222111000000000000222100000000000000000000004444433333210000000021000000000000000000
33444444444444444444444444433322211100000000111100000000000000112222211100000000000000444443332222222100004321000000000000000000
22444444444444444444444444432221110000000000000000000000000000001121110000000000000033334333222111111100004321000000000000000000
11444444444444444444444444432111000000000000000000000000000000000011000000000000000022223322211100000000004444444444444444444321
00444444444444444444444443332100000000000000000000000000110000000000000000000000000011112221110000000000444444444444444444444321
00444444444444444444444443222100000000000000000000000000000000002100000000000021000000002111000000000044444444444444444444444321
44444444444444444444433333211100000000000000000000000000000000001100000000000021000000001100000022334444444443333333333344444321
44444444444444444443332222210000000000000000000000000000000000000000000000000033210000000000001111224444444333222222222233444321
44444444433333333333222111110000000000000000000000000000000000000000000000002222210000000000110000114444433322211111111122444321
33444443332222222222211100000000000000000021110000000000001100000000000000111111210000000000000000004444432221110000000011333321
22444333222111111111110000000000000000002221000000000000000000000000000000000000110000000000000000004444432111000000000000222221
11333322211100000000000000000000000000211111000000000000000000000000002100000000001100000000000000004443332100000000000000211111
00222221110000000000000000000000000000110000110000211100000000000000111100000000000000000000000000004333222100000000000000110000
00111111000000000000000000000000000000000000002221110000000000000000000000000000000000000000000000433322211100000000000000000000
00000000000000000000000000000000000000000000002111000000000000002100000000001100000000000000000043332221110000000000000000000000
00000000000000000000000000000000000000000000211100000000000000211100000000000000000000000000004443222111000000000000000000000000
00000000000000000000000000000000000000000022210000000000000000110000000000000000000000000000444443211100000000000000000021000021
00000000000000000000000000000000002100000011210000000000000000000000000000000000000000000044444333210000000000000000004444444321
00000000000011332100000000000000002100000000110000000000000000000000002100000000000000004333333322210000000000000000444444444321
00000000000000222100000000000000001100000000000000000000001100000000211100000000000000433322222221110000000000000044444444444321
00000000000000211100000000000000000011000000000000000000000000000000210000000000000044432221111111000000000000000044444444444321
44432100000000110000000000000021000000110000000000000000000000000000210000000000004444432111000000000000000000000044444444444321
44432100000000000000000000002111000000000000000000002100000000000021110000000000004443332100000000000000000000004444444444433321
44432100000000000000000000002100000021000000000000001100001122222111000000000000004333222100000000000000000000444444444444432221
44432100000000000000000000002100002111000000000000000000000011211100000000000000433322211100000000000000000044444444444444432111
44444321000000000000000000211100001100000000000000210000000000110000000000000000432221110000000000000000004444444444444444432100
44444443222100000000000000210000000000000000000011110000000000000000000000000000432111000000000000000000444444444444444433332100
44444443211100000000000000210000000000000000000000000000000000000000000000000044432100000000000000000033444444444444444432222321
44444443210000000000000044444443210000000000210000000000000000000000000000004444432100000000000000111122334444444444444432111321
444444432100000000000000444444432100000000002221000000000000000000000000000044444321000000000000000000112233444443333333321MM321
44444443210000000000000044444443210000000000211100001100000000000000000000004444432100000000000000000000112244444322222232111321
444444432100000000000044444444432100000000432100000000000000000000000000004444444321000000000000000011000011444443211111221MM321
44444444432100000000444444444444432100004443210000000000000000000000000044444444432100000000000000000021000033333321MMMM11113321
444444444444444444444444444444444444444443332111000000000000000000000000444444444443210000000000000000210000222222333321MMMM2221
44444444444444444444444444444444444444433322210000000000000000000000000044444444444443210000000000001121000011111122222233222111
44444444444444444444444444444444444444432221110000000000000000000000000044444444444444432100000000000011210000000011111122211100
44444444444444444444444444444444444444432111000000000000000000000000000044444444444444444321000000000000222100000000000011110000
33334444444444444444444444444444444444432100000000000000000000000000000044444444444444444321000000000000111122332100000000000011
22224444444444444444444444444444444444432100000000000000000000000000000044444444444444444321000000000011000011223322211100000000
21114444444444444444444444444444444444444321000000000000000000000000004444444444444444444443210000001100000000112221110000000000
21004444444444444444444444444444444444444321000000000000000000000000224444444444444444444444432100000000000000001111000000000000
21003333444444444444444444444444444444444321000000000000000000000000114444444444444444444444444321000000000000000000000000000000
22222222334444444444444444444444444444444321000000000000000000000000004444444444444444444444444321000000000000000000000000000000
11111111223344444444444444444444444444444443210000000000000000000000003333334444444444444444444321000000000000000000000000000000
00000000112233333333444444444444444444444443332221111121000000000000002222223344444444444444444443210000000000000000002111000000
00000000001122222222444444444444444444444443222111000011210000000000002111112233444444444444444444432100000000000000211100000000
43222111000011211111444444444444444444444443211100000000110000000000001100001122444444444444444443333321000000000000110000000011
4321110000000021VVVV444444444444444444444443210000000000000000000000000000000011444444444444444443222222322223210000000000000000
3321000000000021VVVV333333344444444444444443210000000000000000000000210000000000444444444444444443211111221112210000000043210000
2221000011000011211122222223334444444444433322210000000000000000000011000000000044444444444444444321MMMM111MM1122100004444432100
111111110000000011MM11111112224444444444432221111100002100000000000000000000000033444444444444444444321MM1MM1MM11111344444444321
0000000000000000001MM1MM1MM11144444444444321110000000011000000000000002100000000224444444444444444433333333333210000244444444321
000000000000000000221MM1MM11MM44444444444321000000000000000000000000211100000000114444444444444444432222222223210000144444444321
000000000000000000112222221MM233444444444321000000000000000000000000210000000000003344444444444444432111111114321000044444444321
00000000000000000000111111111122334444444321000000000000000000000000210000000000002233444444444444432100000004321000044444444321
00000000000000000000000000000011223344444321000000002100000000000000112100000000001122334444444444432100000004321000044444444321
00000000000000000000000000000000112233433322210000001100000000000000002100000000000011224444444444444432100004444444444444444321
00000000000000000000222222211100001122332221110000000000000000000000002100000000000000114444444444444444444444444444444444444321
00000000000011000022211111110000000011222111000000000000000000000000211100000000000000003344444444444444444444444444444444444321
00000000000000334321110000000000000000112100000000000000000000000000110000000000000000002233444444444444444444444444444444444321
00000000000000223321000000000000002100001100000000000000000000000000000000000000000000001122334444444444444444444444444433333321
00000000000011112221000000000000001121000021000011000000000000000000000000000000000000000011223333333333333333333333333332222221
00000000000000001122210000002100000021000022210000000000000000000000000000000000000000000000112222222222222222222222222222111111
00000000000000000011110000001111000011000011110000000000000000000000001100000000000000000000001111111111111111111111111111100000
00000000000000000000000000000000000000000000000000000000000000000000000000000000000000000000000000000000000000000000000000000000
