33332211111111144444444444444444444333210000000000444444444321000000112222224444444444444444444444444444444432222111111112222221
2222211MMMMMMMM444444444444444444443222100000000444444444444432100000011111144444444444444444444444444444444321111MMMM1MM1111121
211111MM21MM444444444444444444444443211100004444444444444444444321000000000033444444444444444444444444444444321MMMM21MM321VVVV21
21VVVV44444444444444444444444444444321000000444444444444444444444321000000002233444444444444444444444444444444444444444321VVVV21
21VVVV44444444444444444444444444444321000033444444444444444444444443210000001122444444444444444444444444444444444444444444444321
44444444444444444444444444444444444321000022444444444444444444444443210000000011444444444444444444444444444444444444444444444321
44444444444444444444444444444444444321000011444444444444444444444443210000000000444444444444444444444444444444444444444444444321
44444444444444444444444444444444444322210000444444444444444444444443210000000000444444444444444444444444444444444444444444444321
44444444444444444444444444444444444321110000444444444444443333334444444322210000444444444444444444444444444444444444444444444321
44444444444444444444444444444444444321000000444444444444443222224444444321110000444444444444444444444444444444444444444444444321
44444444444444444444444444444444444321000011444444444444443211114444433321000044444444444444444444444444444444444444444444444321
44444444444444444444444444444444444322210000444444444444443210004443332221000044444444444444444444444444444444444444444444444321
44444444444444444444444444444444444321110000444444444444443210004333222111000044444444444444444444444444444444444444444444444321
44444444444444444444444444444444444321000000444444444444444444444322211100002233334444444444444444444444444444444444444444444321
44444444444444444444444444444444444321000044444444444444444444444321110000211122224444444444444444444444444444444444444444444321
33444444444444444444444444444444444321000044444444444444433333333321000033210021114444444444444444444444444444444444444444444321
22334444444444444444444444444444444321000044444444444444432222222221000022211121004444444444444444444444444444444444444444444321
11223344444444444444444444444444433321000044444444444444432111112111000021110011003333444444444444444444444444444444444444444321
00112233333344444444444444444444432221000044444444444444432100002100004321000000222222334444444444444444444444444444444444444321
00001122222244444444444444444444432111000044444444333333332100002100004321001100211111223344444444433333334444444444444444444321
00000011211144444444444444444444432100000044444444322222243333211100004321110011110000112233444443332222223344444444444444444321
00000000110033444444444444444444432100001144444444321111133222210000444321000000000000001122334333222111112233444444444444433321
00000000000022444444444444444444432221000044444444321000032211110000433321001100000000000011223322211100001122334444444443332221
0000000000001144444444444444444443211100004444444432100003211MM10000332221000000000000000000112221110000000011224444444443222111
000000000000004444444444444444444321000000444444443210000321MM000043222111210000000000000000001111000000000000113333444443211100
000000000000003344444444444444444321000011444444444444443321MM000043211100210000000000000000000000000000000000002222444443210000
000000000000002244444444444444444443210000444444444444333221MM000043210011210000000000000000000000000000000000001111444443210000
000000000000211144444444444444444443210000444444444444322211MM000043210000222100000000000000000000000000000000000000444333222111
21000000003321004444444444443333344321000044443333333432111MM1000044432100111100210000000000000000000000000000000000433322211100
210000000022444444444444444432222343210000444432222224321MM100002244444321000044432100000000000000000000000000000000332221110000
2100112100114444444444444444321112432100004444321111144321MM00001144444443210044444321000000000000000000000000000000222111000000
2221002100004444444444444444321MM13321000044443210000444432100000044444444444444444443210000000000000000000000000022211100000000
11210043210044444444444444444321MM2321000044443210000444432111000033333444444444444444432100000000000000000000000021110000000000
00444444444444444444444444444432111321000044443210000444432100002222222444444444444444444321000000000000000000000011000000000000
003333444444444444444444444433321MM321000033444444444444432100001111111444444444444444444443210000000000000000001100000000000000
43222244444444444444444444443222222321000022444444444444432100000010000444444444444444444444432221000000000000110000000000000000
43211144444444444444444444443211111321000011444444444444444321000010000444444444444444444444432111000000000011000000000000000000
4321004444444444444444444444321VVVV322210000444444444444444321000010000444444444444444444444432100000000001100000000000000000000
4444444444444444444444444444321VVVV321110000444444444444444321000022444444444444444444444444432100000000210000000000000000000000
44444444444444444444444444444444444321000000444444444444433321000011444444444444444444444444444444444443210000000000000000000000
44444444444444444444444444444444444321000011444444444444332221000000444444444444444444444444444444444443210000000000000000000000
44444444444444444444444444444443333343210000444444444444322111110000444333334444444444444444444444444444432100000000000000000000
433333334444444444444444444444432222432100004444444444443211MM000044444322224444444444444444444444444444444321000000000000000000
33222222334444444444444333333343211143210000444444444444321MM1000044444321114444444444444444444333333344444443210000000000000000
22211111223344444444444322222233210043210000444444444444321MM1000044444321004444444444444444444322222244444444432100000000000000
21110000112244444443333321111122210043210000334444444444444321000044444321004444444444444444444321111144444444444321000000000000
21000000001144444443222221000021110043210000223344444444433321000044444444444444444444444444444321000044444444444443210000000000
21000000000044444333211143210021003343210000112233444443332221000044444333333344444444444444444321000044444444444444432100000000
43210000000044444322210043211121002233332100001122444333222111000044433322222244444444444444444444444444444444444444433321000000
33210000000033444321110043210043211122224321000011333322211100004444432221111144444444444444444444444444444444444443332222210000
22210000000022444321004333210033210021114443210000222221110000444333332111000044444444444444444444444444444443333333222111111100
21110000000011433321003322222222210021004443210000111111000044444322222100000044444444444444444444444444444333222222211100000000
11000000000000332221002221112111334321004443210000000000002244444321112100004444444444444444444444444444444322211111210000000000
00000000000000222111111121002100224444444444432100000000211143333321002100444444444444444444444444444444444321110000110000000000
00000000000000112100000021002100114444444444444444444322210043222221002100444444444444444444444444444444444321000000002100000000
00000000000000001100000011444321004444433333444444444321110043211133334444444444444444444444444444444443333321000000002221000000
00000000000000000000001100444444444444432222433333334321004333210022224444444444444444444333334444444333222222210000332111000000
21110000000000000000000022444444444444432111432222224321003322210021114443333333444444444322224444444322211111223322222100000000
11000000000000000000000011444444444444432100432111113333222221114321004443222222444444444321114444444321110000112221111100000000
000000000000000000000011MM444444444443332100432100002222211121004444444443211111444444444321003333344321000000002111000000000000
00000000000000000000321MM1444444444443222244444321002111210021004444444443210000444444444321003222234321000000002100000000000000
000000000000000000003221MM444444444443211144444444432100210044444444444443210000444444444444443211123321000000002100000000000021
0000000000000000000032111244444444444321004444444443210044444444444444444322224444444444444444321MM12221000000002221000000000011
00110000004321000043321MM1444444444443210044444444432111444444444444444443211144444444444444443211MM2111000000001111112221000000
000000000033433333332221MM44444444444444444444444443210044444444444444444321004444444444444444321MM11100000000000000001111000000
00000000002233222222211123444444444444444444444444444444444444444333334333210044444444444444444321110000000000000000000000000000
0000000000112221111121MM12444444444444444444444444444444444443333322223322224444444444444444443321MM0000000000000000000000000000
00000000000011110000111MM14444444444444444444444444444444443332222211122211144433333444444444432221MM100000000000000000000000000
000000000000000000000021MM444444444444444444444444444444444322211121002111004443222244444444443211124321000000000000000022210000
0000000000000000000000444444444444444444444444444444433333332111002100210000444321114444444444321MM14443210000000000000011444321
00000000000000000000444444444444444444444444444444444322222221000043333344444443210044444444443211MM3333210000000000000000444321
0000000000000000002244444444444444444444444444444443332111112100114322224444444321004444444444321MM32222210000000000000000444321
00000000000000000011444444444444444444444444444444432221000022210043211144444444444444444444433333332111432100001100001133334321
00000000000000000000444444444444444444444444444444432111002111210043210044444444444444444443332222222100334333210000000022223321
00000000000000000000444444444444444444444444444444432100332100444443210044444444444444433333222111211100223322210000000011112221
00000000000000000022444444444444444444444444444444432100222100444444444444444444444444432222211100110000112221110000001100001121
00000000000000000011444444444444444444444444444444444443211144433333334444444444444333332111210000000000002111000000000000000011
00000000000000000000444444444444444444444444444444444443210043332222223333334444444322222100332100000000002100000000000000000000
00000000222100000000444444444444444444444444444444444444444333222111112222223344444321112100222100000000002100000000000000000000
00000000111100000044444444444444444444444444444444444444433322211100001111112244444321002243211121000000332221000000000000000021
00000000000000000044444444444444444444444444444444444443332221110000000000001144444321001143210043211100222111000000000021000011
00000000000000000044444444444444444444444444444444444333222111000000000000000033333343210033210043210011112100000000000021000000
00000000000000004444444444444444444444444444444444433322211100000043210000000022222233210022211143210000001100000000000022210000
11222100000000444444444444444444444444444444444444432221110000004444444321000011111122332111210043210000000011000000000011222111
00112233444444444444444444444444444444444444444444432111000000444444444321000000000011222100210043210000000000110000000000111100
00001122334444444444444444444444444444444444444443332100000044444444444443210000000000114444444333210000000000002100000000000000
00000011223344444444444444444444444444444444444443222100004444444444444444432100000000003343333322210000000000001100000000000000
00000000112233444444444444444444444444444444444443211100004444444444444444444444432100002243222221110000000000000000000000000000
00000000001122334444444444444444444444444444444443210000003333444444444444444444432100001143211121002100000000000000222100000000
00000000000011223344444444444444444444444444444443210000112222344444444444444444432100000033210021001100000000000000111100000000
00000000000000112233444444444444444444444444444444432100002111244444444444444444444321000022210043210021000000000000000000000000
000000000000000011223343333333333344444444444444444321000021MM144444444444444444444321000011210044444444444443210000000000000000
0000000000000000001122332222222222444444444444444443210000111MM44444444444444444444321000000114444444444444443210000000000000000
0000000000000000000011222111111111444444444444444444432100001MM44444444444444444444443210000003344444444444444432100000000000000
00000000000000000000002111000000004444444444444444444443210000444444444444444444444444432100002244444444444444444321000000000000
00000000000000000000001100000000004444444444444444444333210000444444444444444444444444432100001134444444444444444443211121000000
00000000000000000000000000000000444444444444444444444322210000444444444444444444444443332100000024444444444444444443210011000000
00000000000000000000000000000000334444444444444444444321110000444444444444444444444443222111000014444444444444444443210000000000
00000000000000000000000000000000223344444444444444444321000000444444444444444444444443211100001MM4444444444333334444432100210000
0000000000000000000000000000001111223344444444444444432100001144444444444444444444444321000011MM34444444444322223333332111332100
000000000000000000000000000011000011223344444444444333222100004444444444444444444444432100001MM224444444444321112222222100222111
00000000000000000000000000110000000011223344444444432221110000444333333344444444444443210000111114444444444321001121111100211100
000000000000000000000000110000000000001122334444444321110000004443222222444444444444432100001VVVV4444444444321000021000000110000
000000002100000000000011000000000000000011223344444321000000334443211111444444444444432100001VVVV4444444444333210011000000000021
00000043210000000000110000000000000000000011223333332100001122333321VVVV44444444444443210000444444444444444322211100000000000011
00004443210000222111000000000000000000000000112222222221000011222221VVVV44444444444443210000444444444444444321110000000000000000
00444444444443211100000000000000000000000000001121111111210000111114444444444444444443210000444444444444444321000000000000000000
44444444444443210000000000000000000000000000000011000000432100001MM4444444444444444333210000444444444444444321000000000000000000
44444444444443210000000000000000000000000000000000002100332100001MM4444444444444444322210000444444444444444444432100000000000000
4444444444444321000000000000000000000000000000000000110022210000MM14444444444444444321110000444444444444444444444321000000000000
44444444444444432100000000000043210000000000000000000000211100001MM4444444444444444321000044444444444444444444444443210000000000
44444444444444444321000000004444432100000000000000000021110000001MM4444444444444444321000044444444444444444444444444432100000000
4444444444444444444321000044444444432100000000000000432100000021MM14444444444444433321000044444444444444444444444444444321000000
44444444444444444444444444444444444443210000000011004321000032111MM4444444444444432221000044444444444444444444444444444443210000
444444444444444444444444444444444444444321000021001133210000321MM444444444444444432111000044444444444444444444444444444444432100
44444444444444444444444444444444444444444321112100002221000044444444444444444443332100004444444444444444444444444444444444444321
44444444444444444444444444444444444444444321004321002111000044444444444444444443222100004444444444444444444444444444444444444321
44444444444444444444444444444444444444444321003322211100000044444444444444444443211100004444444444444444444444444444444444444321
44444444444444444444444444444444444444433333332221110000004444444444444444444333210000444444444444444444444444444444444444444321
44444444444444444444444444444444444444432222222111000000444444444444444444444322210000444444444444444444444444444444444444444321
44444444444444444444444444444444444444432111111100000044444444444444444444444321110000444444444444444444444444444444444444444321
33333444444444444444444444444444444443332100000000004444444444444444444444433321000044444444444444444444444444444444444333333321
22222333333333444444444444444444444333222100000000444444444444444444444444432221000044444444444444444444444443333343333322222221
11111222222222444444444444444444433322211100000044444444444444444444444444432111000044444444444444444444444333222233222221111121
1VVVV111211111333333333333333333332221110000000033333333333333333333333333332100003333333333333333333333333322211122211121VVVV21
1VVVV1MM11MMMM22222222222222222222211100000000002222222222222222222222222222210000222222222222222222222222222111MM1111MM21VVVV11
00000MMMMMM111111111111111111111111100000000000011111111111111111111111111111100001111111111111111111111111111MM1MMMMMM111100000
00000000000000000000000000000000000000000000000000000000000000000000000000000000000000000000000000000000000000000000000000000000
