00443211111222222343210000112233444444444322210000001100000000000000000000001122334444444443332221110000004443211111444444444321
0044321VVVV211111234432100001122334444444321111100000011000000000000000000000011223344444333222111000000444443210000444444444321
4444321VVVV21MMMM124444321000011223344444321000021000000110000000000000000000000112233433322211100000044444443210000444444444321
4444444444444321MM14444443210000112244444321000043210000001100000000000000000000001122332221110000004444444443210000444444444321
44444444444443211MM4444444432100001144444444444444432100000011000000000000000000000011222111000000444444444444333333333344444321
4444444444444321MM44444443332221000044444444444444444321000000110000000000000000000000111100000044444444444444322222222244444321
44444444444444444444444333222111000044444444444444444443210000001100000000000000000000000000004444444444444444321111111143333321
44444444444444444444433322211100000044444444444444444444332100000011000000000000000000000000333344444444444444321000000043222221
44444444444444444443332221110000004444444444444444444444322221000000110000000000000000000022222244444444444444321000000043211111
44444444444444444333222111000000444444444444444444444444321111110000001100000000000000000011211133334444443333321000022243210001
44444444444444433322211100000044444444444444444444444444321VVVV11100000011000000000000000000110022224444443222222321111133210001
44444444444443332221110000004444444444444444444444444444321VVVV1MMMM000000110000000000000000001121114444443211111321000032211121
4444444444433322211100000044444444444444444444444444444444444444321MM1000000110000000000000000001100334444321000032100003211MM21
44444444433322211100000044444444444444444444444444444444444444443211MM21000000110000000000000000001122334432100003210000321MM121
4444444333222111000000444444444444444444444444444444444444444444321MM4432100000011000000000000000000112233321000033333333211MM21
444443332221110000004444444444444444444444433333334444444444444444444443332100000021000000000000000000112233444322222222221MM321
444333222111000000444444444444444444444443332222223344444444444444444333222111000011000000000000000000001122334321111111111MM321
43332221110000004444444444444444444444444322211111223344444444444443332221110000110000000000000000000000001122332100001MM1MM2221
3322211100000044444444444444444444444444432111000011223344444444433322211100001100000000000000000000000000001122210000321MM32111
22211100000044444444444444444444444444444321000000001122334444433322211100001100000000000000000000000000000000112233444444432100
21110000004444444444444444444444444444444321000011000011223343332221110000110000000000000000004321000000000000001122334444444321
11000000444444444444444444444444444444444321000000110000112233222111000011000000000000000000444443210000000000000011223344444321
00000000433333444444444444444444444444444443210000001100001122211100001100000000000000000044444444432100000000000000112233444321
00002100432222444444444444433333334444444444432100000011000011110000110000000000000000004444444444444321000000000000001122334321
00444444432111444444444443332222223344444444444321000000110000000011000000000000000000444444444444444443210000000000000011223321
00433333432100433333444333222111112244444444444443210000001100001100000000000000000044444444444444444444432100000000000000112221
00432222432100432222433322211100001144444444444444432100000011110000000000000000004444444444444444444444444321000000000000001121
44432111444444432111332221110000000044444444444444444321000000000000000000000000444443333333333344444444444443210000000000000011
44432100433333432100222111000011000044444444444444444443210000000000000000000043333333222222222233333344444444432100000000000000
33432100432222432100211100001100000044444444444444444333222100000000000000004333222222211111111122222233444444444321000000000000
22444444432111332221110000110000004444444444444444433322211100000000000000333322211111110000000011111122334444444443210000000000
11444444432100222111000011000000444444444444444443332221110000000000000043222221110000000000000000000011223344444444432100000000
00444444432100211100001100000044444444444443333333222111000000000000004333211111000000000000000000000000112233444444444321000000
00444443332221110000110000004444444444444443222222211100000000000000433322210000000000004432221100000000001122334444444443210000
33444333222111000011000000444444444444444443211121110000000000000043332221110000004444444432111MM1111100000011223344444444432100
224333222111000011000000444444444444433333332100110000000000000043332221110000000044444444321MM1MMMMMM11000000112233444444444321
11332221110000110000004444444444444443222222211100000000000000444322211100000000004444444444444444321MM1210000001122444444444321
002221110000110000004444444444444444432111211100000000000000444443211100000044444444444444444444443211MM432100000011444444444321
00211100001100000044444444444444444443210011000000000000004444444321000000444444444444444444444444321MM4444321000000444444444321
21110000110000004444444444444444444444432100000000000000223344444321000011444444444444444444444444444444444443210000444444444321
11000011000000444444444333333333334444432100000000000000112233444443210000334444444444444444444444444444444443210000444444444321
00001100000044444444433322222222223344444321000000000000001122334443210000223344444444444444444444444444444443210000444444444321
00110000004444444443332221111111112233444443210000000000000011223343210000112233444444444444444444444444444443210000444444444321
11000000444444444333222111000000001122334444432100000000000000112233432100001122334444444444444444444444444333210000444444444321
00000044444444433322211100000000000011223344433321000000000000001122334321000011223343333333444444444444433322210000444444444321
00004444444443332221110000000000000000112244432222210000000000000011223343210000112233222222334444444444432221110000444444444321
00444444444333222111000000444443210000001133332111112100000000000000112233432100001122211111223344444444432111000044444444444321
44444444433322211100000044444444432100000022222100004321000000000000001122334321000011110000112233444443332100004444444444433321
44444444432221110000004444444444444321000011112100004443210000000000000011223343210000000000001122334333222100004444444443332221
44444444432111000000444444444444444321000000001122224444432100000000000000112233432100004321000011223322211100004444444333222111
44444444432100000044444444444444444321000000000011113344444321000000000000001122334444444443210000112221110000444444433322211100
44444444432100003344444444444444444443210000000000002233444443210000000000000011223344444444432100001111000044444443332221110000
44444444432100002244444444444444444444444443210000001122444444432100000000000000112233444444444321000000004444444333222111000011
44444444432100001144444444444444444444444443210000000011444444444321000000000000001122444444444443210000444444433322211100001100
44444444444321000044444444444444444444444443210000000000444444444443210000000000000011444444444444444444444443332221110000110000
44444444444321000044444444444444444444444444444443210000444444444333222100000000000000444444444444444444444333222111000011000000
44444444444321000033444333334444444444444444444443210000444444433322211100000000000000444444444444444444433322211100001100000011
44444444444321000022334322223444444444444444444333210000444443332221110000000000000011444444444444444443332221110000110000002100
33444444444321000011223321112444444444444444433322210000444333222111000000000000002100444444444444444333222111000011000000432100
22334444444443210000112221MM1333333334444443332221110000433322211100000000000000444444444444444444433322211100001100000011444321
112233444444444321000011221MM222222223333333222111000043332221110000000000000011444444444444444443332221110000110000002100433321
001122334444444443210000111MM111111113222222211100004333222111000000000000002100444444444444444333222111000011000000432100432221
0000112233444444444321000011MMMMMM1MM2211111110000433322211100000000000000444444444444444444433322211100001100000011444444432111
0000001122334444444443210000111111MM21110000000043332221110000000000000044444444444444444443332221110000110000002100433333432100
00000000112233444444444321000000001111000000004333222111000000000000004444444444444444444333222111000011000000432100432222432100
00000000001122334444444443210000000000004444433322211100000000000000334444444444444444444322211100001100000044444444432111444321
00000000000011223344444444444443210000444443332221110000000000000011223344444444444444444321110000110000001144444444432100433321
00000000000000112233444444444444444444444333222111000000000000000000112233444444444444444321000011000000210043333344432100432221
21000000000000001122334444444444444444433322211100000000000000000000001122334444444444444321000000000043210043222244444444432111
43210000000000000011223344444444444443332221110000000000000000001111000011223344444444444321000000004444444443211144444444432100
33432100000000000000112233444444444333222111000000000000000000110000110000112233444444444443210000444444444443210043333343332100
22444321000000000000001122334444433322211100000000000000000011000000001100001122334444444444444444444444444443210043222233222221
11444443210000000000000011223343332221110000000000000000001100000000000011000011223344444444444444444444444444444443211122211111
00444444432100000000000000112233222111000000000000000000110000004321000000110000112244444444444444444444444444444443210021110000
44333333333321000000000000001122211100000000000000000011000000444443210000001100001144444444444444444444444444444333210011000000
43322223222222210000000000000011110000000000000000001100000044444444432100000011000044444444444444444444444444433322211100004321
33221112211111432100000000000000000000000000000000110000004444444444444321000000000044444444444444444444444443332221110000444321
32211MM111VVVV444321000000000000000000000000000011000000444444444444444443210000000044444444444444444444444333222111000044444321
3211MM1MM1VVVV444443210000000000000000000000001100000044444444444444444444432100004444444444444444444444433322211100004444444321
221MM444444444444444432100000000000000000000210000003344333334444444444444444444444444444444444444444443332221110000444444444321
211MM444444444444444444321000000000000000000110000112233322223444444444444444444444444444444444444444333222111000044444444444321
21MM1444444444444444444443210000000000000000001100001122321112444444444444444444444444444444444444433322211100004444444444444321
211MM444444444444444444444432100000000000000000011000011221MM1333333334444444444444444444444444443332221110000444444444444444321
21MM44444444444444444444444443210000000000000000001100001121MM222222224444444444444444444444444333222111000044444444444444444321
444444444444444444444444444443211100000000000000000011000011MM111111114444444444444444444444433322211100004444444444444444444321
4444444444444444444444444444432100210000000000000000001100001MMMM1VVVV4444444444444444444443332221110000444444444444444444444321
444444444444444444444444444444444321110000000000000000001100001121VVVV4444444444444444444443222111000044444444444444444444444321
44444444444444444444444444444443332100110000000000000000001100001122334444444444444444444443211100004444444333334444444444444321
44444444444444444444444444444333222111000000000000000000000011000011223344444444444444444443210000223344443322224444444444444321
44444444444444444444444444433322211100000000000000000000000000110000112233444444444444444443210000112233443221114444444444444321
44444444444444444444444443332221110000432100000000000000000000001100001122334444444444444443210000001122333211MM3333333334444321
3333344444444444444444433322211100004444432100000000000000000000001100001122334444444444444443210000001122321MM12222222223333321
22222333333333333333333322211100003333333333210000000000000000000000110000112233333333333333333321000000112221MM1112111112222221
111112222222222222222222211100002222222222222221000000000000000000000011000011222222222222222222222100000011221MMMM21VVVV2111111
000001111111111111111111110000111111111111111111110000000000000000000000110000111111111111111111111111000000111111111VVVV1100000
00000000000000000000000000000000000000000000000000000000000000000000000000000000000000000000000000000000000000000000000000000000
