44443211111444444443210000000044432100000000000000111122334444444444433333334333333344444443210000004444444444444432111114444321
333432100004444444444443210000444321000000000000000000112244444444433322222243222222334444444321000044444444444444321VVVV4333321
222332100004444444444443210000444443210000000000000000001144444444432221111143211111224444444321000033444444444444321VVVV3322221
11124444444444444444433321000044444443210000000000000000003333444443211100004321000011444444432100002244444444444444444443221111
1MM14444444444444444432221000044444444444321000000000000002222334443210000004321000000444444432100001144444444444444444443211MM1
21MM444444444444444443211100004444444444432100000000000000111122334321000000432100000044444443210000004444444444444444444321MM21
11124444444444444444432100000044444444444443210000000000000000112244432100004321000044444444444321000044444444444444444443221111
1MM14444444444444444432100004444444444444443210000000000000000001133444444444444444444444444444321000033444444444444444443211MM1
21MM444444444444444333210000444444444444433321000000000000000000002244444444444444444444444444432100002233444444444444444321MM21
11MM444444444444444322210000444444444443332222210000000000000000001144444444444444444444444444432100001122334444444444444321MM11
1MM44444444444444443211100004444433333332221111121000000000000000000444444444444444444444444444321000000112244444444444444321MM1
44444444444444444333210000004443332222222111000011000000000000000000444444444444444333333344444443210000001144444444444444444321
44444444444443333322210000444443222111112100000000210000000000000000334444444444444322222233444444432100000033334444444444444321
44444444444333222221110000444443211100001100000000432100000000000000224444444444444321111122444444444321000022223344444444444321
44444444444322211111000000444443210000000021000044444443210000000000114444444444444321000011444444444321000011112244444444444321
44444333333321110000000044444443210000000044444444444443210000000000003344444444444321000000444444444321000000001133333344444321
44433322222221000000001144444444432100004444444444444443210000000000002244444444444443210000444444444321110000000022222233444321
33332221111111000000000044444444444444444444444444444443210000000000001144444444444444444444444444444321000000000011111122334321
22222111000000000000000044444444444444444444444443333333210000000000000044444444444444444444444444444321000000000000000011224321
11111100000000000000000044444444444444444444444333222222210000000000000044444444444444444444444444444321000000000000000000113321
00000000000000334444444444444444444444444444433322211111210000000000003344444444444444444444444444444444444333332100000000002221
00000000444322224444444444444444444444444443332221110000111100000000222233433333333333444444444444444444444322222111432100001111
00000044444321113333444444444444444444444443222111000000000000000011111122332222222222333333444444444444444321112100432100000000
00003344444321002222334444444444444444444443211100004321000000000000000011222111111111222222334444444444444321002100432100000000
00002233333321001111224444444444444444444443210000224444444444432100000000111100000000111111223344444444444444444444433321000000
00001122222221110000114444444444444444433333210000114444444444444444432100000000000000000000112244444444444333333344432221110000
21000011211121000000003344444444444443332222210000004444444444444444444321000044444321000000001144444444444322222244432111000021
43210000110021000000002233444444444443222111111100004444444444444444444444444444444444444321000033444444444321111143332100002221
43222100004444432221111122444444444443211100000000444444444444444444444444444444444444444321000022444444444321000043222100002111
43211100004444432111000011444444444333210000000044444444444444444444444444444444444444444321000011444444444321000043211100002100
43210000004444432100000000444444444322210000444444444444444444444444444444444444444444433322210000444444444443333343210000002100
33210000004444432100000000444444444321110000444444444444444444444444444333334444444443332221110000433333334443222244432100002100
22210000004444444321000022444444444321000022444444444444444444444444444322224444444333222111000000332222223343211144432100002100
11110000334444444322211111444444444321000011444444444444444444444444444321114444444322211100000043222111112243210043332100001111
00000000224444444321110000444444444321000000334444433333444444444444444321004444444321110000000043211100001144444443222100000000
00000000114444444321000000444444444443210000223333332222444444444444444321004333333321000000000033210000000033444443211100000000
000000VVVV444444432100004444444444444321000011222222211144444444444444433333332222222100004443332221000000002244444321VVVV000000
222221VVVV444444444444433333334444444321000000111111210033334444433333332222222111111100004443222111110000111144444321VVVV444321
21114444444444444444444322222233333344432100000000001122222233333322222221111111000000000033332111000011210000444444444444333321
11MM4444444444444444444321111122222233444321000000000011111122222221111111000000000000003322222100000000210000444444444443322221
1MM24444444444444444444321000021111122444443210000000000000011111111000000000000000000332221111100000000444444444444444443221111
1MM14444444444444444444321000021000011444444444443210000000000000000000000000000444443222111000021000044444444444444444443211MM1
11MM444444444444444444444444432100000044444444444443210000000000000000000044444443333321110000004444444444444444444444444321MM11
1MM14444444444444444444444444443210000444444444444444444432100000000444444444443332222210000004444444444444444444444444443211MM1
21MM444444444444444444444444444444444444444444444444444444444444444444444444433322211111000044444444444444444444444444444321MM21
4444444444444444444444444444444444444444444444433333334444444444444444444443332221110000444444444444444444444444444444444321MM11
44444444444444444444444444444444444443333333333322222233444444444444444443332221110000004444444444444444444444444444444444321MM1
44444444444444433333334444444444444333222222222221111122444444444444444333222111000000223344444444444443333333333344444444444321
44444444444443332222223333333333333322211111111121000011333344444444433322211100000011112233333333333333222222222244444444444321
44444444444333222111112222222222222221110000000011000000222233444443332221110000001100001122222222222222211111111144444444444321
44444444433322211100001111111111111111000000000000110000111122334333222111000000110000000011111111111111110000000033444444444321
44444443332221110000000000000000000000004444432100001121000011224322211100000011000033210000000000000000000000000022444444444321
44444443222111000043210000000000000000444444444321000021000000114321110000001100003322222100000000000000004321000011444444444321
44444443211100004444444444444444444444444444444321000021000000003321000000110000222221111122244444444444444443210000334444444321
44444333210000444444444444444444444444444444443321000011000000002221000011000021111121000011144444444444444443210000224444444321
44444322210000444444444444444444444444444444443222210000114321111111112100003321000021000000044444444444444443210000114444444321
44444321110000444444444444444444444444444444443211122100003321000000002100002221000021000000044444444444444444432100004444444321
4443332100004444444444444444444444444444444444321MM11100002221000000001100001113333333210000444444444444444443332100004444444321
44432221000044444444444444444444444444444444443221110000002111112243210000221MM3222222210000444444444444444443222100004444444321
44432111000044444444444444444444444444444444443211MM0000211100001143210000111123211111210000444444444444444443211100004444444321
4443210000444444444444444444444444444444444444321MM1000021000000003321000000MM13210000444444444444444444444443210000003344444321
44432100003344444444444444444444444444444444443211110000110000000022211100001MM3210000444444444444444444444443210000112244444321
4443210000223333444444444444444444444444444444321MM1210000110000111121000021MM23210000444444444444444444444444432100001144444321
44432100001122223344444444444444444444443333333211MM222100002111000021000021MM14444443333334444444444444444444444321000044444321
4443210000001111224444444444444444444444322222221MM12111000021000000110000321MM3344443222224444444444444444443333321000044444321
44444321000000001133444444444444444444443211111321MM2100000021000021000022321112244443211114444444444444444333222221000044444321
4444432111000000002233444444444444444444321VVVV333222100003322222221000011221MM1144443210004444444444444444322211111000044444321
4444432100000000001122444444444444444444321VVVV322211100002221111121000000111000044443210004444444444444433321110000000044444321
44444321000000000000114444444444444444444444444321110000002111000011210000001000044444444444444444444443332221000000001144444321
44444321000000000000003344444444444444444444444321000000432100000000332100001000044444444444444444444443222111000000000044444321
44444444444444432100002244444444444444444444444321000011332100000000222100004444444444444444444444444443211100000000000044444321
44444444444444432100001144444444444444444444433322210000222221000011112100004444444444444444444444444443210000000000000044444321
44444444444444432100000044444444444444444444432221110000111143211100002100003344444444444444444444444443210000444444444444444321
44444444444444432111000044444444444444444444432111000000000033210000002100002233333344444444444444444333210000444444444444444321
44444444444444432100004444444444444444433333332100000021000022210000222100001122222233444444444444444322210000444444444444444321
44444444444444432100003344444444444443332222222100004443211111211113211100000011111122334444444444444321110000444444444444444321
44444444444444432100002244444444444333222111111100004443210000210003210000000000000011223344444444433321000000444444444444444321
44444444444444432100001144444444444322211100000000004443210000210003210000000000000000112233444444432221000044444444444444444321
44444444444444432100000033444443333321110000000000334444444444444444432100002100000000001122444333332111000044444444444444444321
44433333334444444321000022333333222221000000000022224444444333333344444444432111000000000011333322222100000044444444444444444321
44432222224444444321000011222222211111000043222111114333333322222233444444432100000000000000222221111100004444444444433333334321
44432111114444444321000000111111110000000043211100004322222221111122333333432100000000210000111111000000004444444444432222224321
33332100004443333333210000000000000000000043210000004321111111000011222222444321000043210000000000000000004444444444432111114321
22222100004333222222432100000000000000001143210000433321000000000000111111444444444333210000000000000000444444444444432100004321
21111122444322211111444321000000002111000044444443332221000000432100000000334444444322222100000000444444444444444444432100003321
21000011444321110000444444444444432100000044444333222111000044444321000000223344444321111111000011444444444444444444444443222221
21000000444321000000444444444444432100004444433322211100004444444443210000112244444321000000000000334444444444444444444443211111
21000000444321000044444444444444444444444444432221110000444444444444432100001144444321000000000000224444444444444444444443210000
11432111444444444444444444444444444444444444432111000044444444444444432221000044444444432100000000114444444444444444444443210021
00432100444444444444444444444444444444444444432100002244444444444444432111000033334444432100000000004444444444444444444443222221
00432100444444444444444444444444444444444333332100001144444444444444432100000022224444444321000000004444444444444444433333211111
33332111444444444444444444444444444444433322222100000044444444444444432100001111114444444443210000444444444444444444432222210000
22222100444444444444444444444444444443332221111111000044444444444444444321000000004444444444444444444444444444444444432111111111
21112100444444444444444444444444444443222111000000003344444444444444444322210000004444444444444444444444444444444444432100000000
21003333444444444444444444444444444443211100000000222244444444444444444321110000004444444444444444444444444444444444444333210000
21002222333344444444444444444444444443210000211111111133444444444444433321000000004444444444444444444444444444444444444322222221
21111111222244444333333344444444444443210000210000000022333333333333332221000000004444444444444444444444444444444444444321111121
21000000211144444322222233444444444443210000111122211111222222222222222111000044444444444444444444444444444444444444433321000021
21000000210044444321111122444444444443210000000011110000111111111111111100000044444444444444444444444444444444444444432222224321
43210000210044444321000011444444444443210000000000000000000000000000000000004444444444444444444444444444444444444444432111114321
43222222222244444321000000444444444444432100000000000000000000000000000000444444444444444444444444444444444444444444432100004321
43211121111144444443210000444444444444444444432100002221000000000000000044444444444444444444444444444444444444433333332100003321
43210021000044444444444444444444444444444444444443222111000000000000334444444444444444444444444444444444444443332222222111112221
43210021000044444444444444444444444444444444444443211100000000000000224444444444444444444444444444444444444333222111111100001121
44444444444444444444444444444444444444444444444443210000000000000000114444444444444444444444444444444444444322211100000000000011
33433333334444444444444444444444444444444444444443210000000000000000004444444444444444444444444444444444433321110000000043210000
22332222223333334444444444444444444444444444444444432100000000000000004444444444444444444444444444444443332221000044444444432100
11222111112222223344444444444444444444444444444444432100000000000000223344444444444444444444444444444333222111004444444444444321
00111100001111112233334444444444444444444444444444432100000000000000112244444444444444444444444444444322211100004444444444444321
00000000000000001122223344444444444444444444444444444321000000000000001144444444444444444444444444433321110000004444444444444321
21000033210000000011112244444444444444444444444444444321000000000000000044444444444444444444433333332221000000004444444444444321
22222222444443210000001133444444444444433333334444444321000000000000000044444444444444444443332222222111000000004444444444444321
21111111444443210000000022334444444443332222224444444443210000000000000033334444444444444443222111111100000000004444444444444321
21000000444443210000000011224444444443222111114444444444432100000000000022223344444444444443211100000000444444444444444444444321
21000000444443210000000000114444444443211100004444444444432100000000000011112233444444444333210000000044444444444444444443333321
22224444444444444444432100003333334443210000004444444444432100000000000000001122444444444322210044444444444444444444444443222221
21114444444444444444444321002222224443210000003333333333432100000000000000000011334444444321110033444443333333444444444443211121
21MM444444444444444444432100111111444443210000222222222243210000000000000000000022334444432100002244444322222244444444444321MM21
11124444444444444444444321000000003344444444432111111111444321000000000000000000112244444321000011444443211111444444444443221111
1MM14444444444444444444443210000002244444444432100000000444443210000000000000000001133334443210000433333210000444444444443211MM1
21MM444444444444444444444444432100114444444443210000000044444321000000000000000000002222334443210043222222444444444444444321MM21
11MM444444444444444444444444432100003344444444432100004444444443210000000000000000001111224333210043211111444444444444444321MM11
1MM13333344444444444444444444443210022334444444444444444444444444321000000000000000000001143222100432100004444444444333333211MM1
21MM222224444444444444444444444321001122444444444444444444444444444443210000000000000000004321110043210000444444444432222221MM21
22221111133333333333333333333333210000113333333333333333333333333333332100000000000000000033210000333333333333333333321111122221
11111VVVV22222222222222222222222222100002222222222222222222222222222222100000000000000000022210022222222222222222222221VVVV11111
00000VVVV11111111111111111111111111111001111111111111111111111111111111100000000000000000011110011111111111111111111111VVVV00000
00000000000000000000000000000000000000000000000000000000000000000000000000000000000000000000000000000000000000000000000000000000
